1111111111111111111111111111111111
1E0000000000C10C00000C000000000001
1010010100111100101001000000010101
1C10010010101010001001000000010111
1P0000000C00C000000000000000000001
1111111111111111111111111111111111