1111111111111
10C10000000C1
100000P00C001
100C01E000001
1111111111111